
111111111111111
100000000000101
100001000000101
111100000010101
100000000010101
100000001111101
100000000000001
100000000000001
111111000111101
100000000000001
111111111111111

11111111111
10000111111
10010111111
10000111111
11111111111
11111111111
11111111101
11000001111
11001001111
11000001111
11111111111
10000000001
11111111111
11111111111